--------------------------------------------------------------------------------#$-------------------------------------------------------------------------------$
--------------------------------------------------------------------------------#$-------------------------------------------------------------------------------$
-----------------------##########---##--##---------------------##########-------#$----------------------------$$$$$$$$$$$$$$---$$$$$$$$$$$$$$$$$-----------------$
##########-----------------#------------##########------------------#-----------#$$$$----$$$$$$$$$$---------------$$------------*------------------$$$$-----$$$$$$
-------------########------------------------#-------########-----------------------------*------------------------------------------------*---------------------
---------------*-----------------------------------------*---------*---------------- ----------------*-------------------$-------------$$$$$$$$$-----------------
##########-------------------*---#------*--------------------------###----#######$$$$$$$$$-------$$------------$$$$$-----$-------$$--$$------------$$--$$$$$$$$$$$
------------------#---------###---################-----#--#---------------------#$---------------$$$$$$$$$$$-------------$--------------------$$$$---------------$
------------##########------------------------------##########------------------#$------------------------------------$$$$$$$$$----------------------------------$
--------------------------------------------------------------------------------#$-------------------------------------------------------------------------------$
