#-------------------------------------------------------------------------------#$-------------------------------------------------------------------------------$&-------------------------------------------------------------------------------&
#-------------------------------------------------------------------------------#$-------------------------------------------------------------------------------$&-------------------------------------------------------------------------------&
#-----------------------##########---##--##---------------------##########------#$----------------------------$$$$$$$$$$$$$$---$$$$$$$$$$$$$$$$$-----------------$&-----------------------&&&&&&&&&&---&&--&&---------------------&&&&&&&&&&------&
###########-----------------#------------##########------------------#----------#$$$$----$$$$$$$$$$---------------$$------------*------------------$$$$-----$$$$$$&&&&&&&&&&&-----------------&------------&&&&&&&&&&------------------&----------&
--------------########------------------------#-------########----------------------------*------------------------------------------------*------------------------------------&&&&&&&&------------------------&-------&&&&&&&&-------------------
----------------*-----------------------------------------*---------*--------------- ----------------*-------------------$-------------$$$$$$$$$----------------------------------*-----------------------------------------*---------*------------
###########-------------------*---#------*--------------------------###---#######$$$$$$$$$-------$$------------$$$$$-----$-------$$--$$------------$$--$$$$$$$$$$$&&&&&&&&&&&-------------------*---&------*--------------------------&&&---&&&&&&&
#------------------#---------###---################-----#--#--------------------#$---------------$$$$$$$$$$$-------------$--------------------$$$$---------------$&------------------&---------&&&---&&&&&&&&&&&&&&&&-----&--&--------------------&
#------------##########------------------------------##########-----------------#$------------------------------------$$$$$$$$$----------------------------------$&------------&&&&&&&&&&------------------------------&&&&&&&&&&-----------------&
#-------------------------------------------------------------------------------#$-------------------------------------------------------------------------------$&-------------------------------------------------------------------------------&
