#-------------------------------------------------------------------------------#$-------------------------------------------------------------------------------$&-------------------------------------------------------------------------------&
#-------------------------------------------------------------------------------#$-------------------------------------------------------------------------------$&-------------------------------------------------------------------------------&
#-----------------------##########---##--##---------------------##########------#$----------------------------$$$$$$$$$$$$$$---$$$$$$$$$$$$$$$$$-----------------$&-----------------------&&&&&&&&&&---&&--&&---------------------&&&&--&&&&------&
###########-----------------#------------##########------------------#----------#$$$$----$$$$$$$$$$---------------$$---------------*--------------$$$$$-----$$$$$$&&&&&&&&&&&-----------------&------------&&&&&&&&&&--------------*--&&----------&
--------------########------------------------#-------########----------------------------*------------------------------------------------*-------------------------*---------&&&&&&&&&-----------------------&&------&&&&&&&&&-------------------
----------------*-----------------------------------------*---------*--------------- ----------------*-------------------$-------------$$$$$$$$$-----------*----------------------------------------------------------------*----------------------
###########-------------------*---#------*--------------------------###---#######$$$$$-----------$$------------$$$$$-----$-------$$--$$------------$$--$$$$$$$$$$$&&&&&&------------------------*-&&&---------------------------------&&&---&&&&&&&
#------------------#---------###---################-----#--#--------------------#$---------------$$$$$$$$$$$-------------$----------------------$$$--------------$&-----&&&&&---*----&---&-----&&&---&&&&&&&&&&&&&&&&-----&--&--------------------&
#------------##########------------------------------##########-----------------#$------$$$---------------------------$$$$$$$$$$---------------------------------$&------------&&&&&&&&&&------------------------------&&&&&&&&&&-----------------&
#-------------------------------------------------------------------------------#$-------------------------------------------------------------------------------$&-------------------------------------------------------------------------------&
