----------------------------------------
----------------------------------------
-----------------------##########-------
##########------------------------------
-----------##########-------------------
----------------------------------------
##########------------------------#####-
----------------------------------------
------------##########------------------
----------------------------------------

