--------------------------------------------------------------------------------
--------------------------------------------------------------------------------
-----------------------##########---##--##---------------------##########-------
##########-----------------#------------##########------------------#-----------
-------------########------------------------#-------########-------------------
--------------------------------------------------------------------------------
##########------------------------#--------------------------------###----######
------------------#---------###---################-----#--#---------------------
------------##########------------------------------##########------------------
--------------------------------------------------------------------------------

